"filename", "language", "TypeScript JSX", "SCSS", "TypeScript", "HTML", "comment", "blank", "total"
"e:\taroDemos\cloudmate\src\apis\approval.ts", "TypeScript", 0, 0, 110, 0, 0, 11, 121
"e:\taroDemos\cloudmate\src\apis\attandence.ts", "TypeScript", 0, 0, 9, 0, 0, 5, 14
"e:\taroDemos\cloudmate\src\apis\auth.ts", "TypeScript", 0, 0, 7, 0, 0, 2, 9
"e:\taroDemos\cloudmate\src\apis\chat.ts", "TypeScript", 0, 0, 57, 0, 0, 4, 61
"e:\taroDemos\cloudmate\src\apis\constants.ts", "TypeScript", 0, 0, 2, 0, 0, 1, 3
"e:\taroDemos\cloudmate\src\apis\contacts.ts", "TypeScript", 0, 0, 30, 0, 0, 5, 35
"e:\taroDemos\cloudmate\src\apis\request.ts", "TypeScript", 0, 0, 43, 0, 0, 16, 59
"e:\taroDemos\cloudmate\src\apis\share.ts", "TypeScript", 0, 0, 115, 0, 0, 17, 132
"e:\taroDemos\cloudmate\src\apis\user.ts", "TypeScript", 0, 0, 5, 0, 0, 1, 6
"e:\taroDemos\cloudmate\src\app.config.ts", "TypeScript", 0, 0, 20, 0, 0, 1, 21
"e:\taroDemos\cloudmate\src\app.scss", "SCSS", 0, 0, 0, 0, 0, 1, 1
"e:\taroDemos\cloudmate\src\app.tsx", "TypeScript JSX", 33, 0, 0, 0, 0, 5, 38
"e:\taroDemos\cloudmate\src\components\action-sheet\index.module.scss", "SCSS", 0, 61, 0, 0, 2, 9, 72
"e:\taroDemos\cloudmate\src\components\action-sheet\index.tsx", "TypeScript JSX", 52, 0, 0, 0, 1, 9, 62
"e:\taroDemos\cloudmate\src\components\auth\index.tsx", "TypeScript JSX", 34, 0, 0, 0, 0, 8, 42
"e:\taroDemos\cloudmate\src\components\avatar\index.module.scss", "SCSS", 0, 56, 0, 0, 0, 3, 59
"e:\taroDemos\cloudmate\src\components\avatar\index.tsx", "TypeScript JSX", 52, 0, 0, 0, 0, 7, 59
"e:\taroDemos\cloudmate\src\components\box\state-box\index.module.scss", "SCSS", 0, 4, 0, 0, 0, 1, 5
"e:\taroDemos\cloudmate\src\components\box\state-box\index.tsx", "TypeScript JSX", 19, 0, 0, 0, 0, 7, 26
"e:\taroDemos\cloudmate\src\components\button\index.module.scss", "SCSS", 0, 21, 0, 0, 0, 4, 25
"e:\taroDemos\cloudmate\src\components\button\index.tsx", "TypeScript JSX", 23, 0, 0, 0, 0, 6, 29
"e:\taroDemos\cloudmate\src\components\checkbox\index.module.scss", "SCSS", 0, 3, 0, 0, 0, 1, 4
"e:\taroDemos\cloudmate\src\components\checkbox\index.tsx", "TypeScript JSX", 42, 0, 0, 0, 0, 7, 49
"e:\taroDemos\cloudmate\src\components\divider\index.module.scss", "SCSS", 0, 12, 0, 0, 0, 1, 13
"e:\taroDemos\cloudmate\src\components\divider\index.tsx", "TypeScript JSX", 16, 0, 0, 0, 0, 4, 20
"e:\taroDemos\cloudmate\src\components\drawer\index.module.scss", "SCSS", 0, 145, 0, 0, 2, 14, 161
"e:\taroDemos\cloudmate\src\components\drawer\index.tsx", "TypeScript JSX", 70, 0, 0, 0, 1, 12, 83
"e:\taroDemos\cloudmate\src\components\float-indicator\index.module.scss", "SCSS", 0, 25, 0, 0, 0, 3, 28
"e:\taroDemos\cloudmate\src\components\float-indicator\index.tsx", "TypeScript JSX", 77, 0, 0, 0, 0, 14, 91
"e:\taroDemos\cloudmate\src\components\header\index.module.scss", "SCSS", 0, 7, 0, 0, 0, 1, 8
"e:\taroDemos\cloudmate\src\components\header\index.tsx", "TypeScript JSX", 19, 0, 0, 0, 1, 6, 26
"e:\taroDemos\cloudmate\src\components\icon\common\index.tsx", "TypeScript JSX", 18, 0, 0, 0, 0, 10, 28
"e:\taroDemos\cloudmate\src\components\icon\index.tsx", "TypeScript JSX", 2, 0, 0, 0, 0, 2, 4
"e:\taroDemos\cloudmate\src\components\image-picker\index.module.scss", "SCSS", 0, 31, 0, 0, 0, 5, 36
"e:\taroDemos\cloudmate\src\components\image-picker\index.tsx", "TypeScript JSX", 56, 0, 0, 0, 0, 11, 67
"e:\taroDemos\cloudmate\src\components\list\index.module.scss", "SCSS", 0, 32, 0, 0, 0, 6, 38
"e:\taroDemos\cloudmate\src\components\list\index.tsx", "TypeScript JSX", 32, 0, 0, 0, 0, 9, 41
"e:\taroDemos\cloudmate\src\components\loading\box\index.module.scss", "SCSS", 0, 16, 0, 0, 0, 2, 18
"e:\taroDemos\cloudmate\src\components\loading\box\index.tsx", "TypeScript JSX", 20, 0, 0, 0, 0, 7, 27
"e:\taroDemos\cloudmate\src\components\loading\icon\index.module.scss", "SCSS", 0, 13, 0, 0, 1, 2, 16
"e:\taroDemos\cloudmate\src\components\loading\icon\index.tsx", "TypeScript JSX", 13, 0, 0, 0, 0, 4, 17
"e:\taroDemos\cloudmate\src\components\modal\index.module.scss", "SCSS", 0, 49, 0, 0, 0, 5, 54
"e:\taroDemos\cloudmate\src\components\modal\index.tsx", "TypeScript JSX", 40, 0, 0, 0, 0, 8, 48
"e:\taroDemos\cloudmate\src\components\popover\index.d.ts", "TypeScript", 0, 0, 12, 0, 0, 5, 17
"e:\taroDemos\cloudmate\src\components\popover\index.module.scss", "SCSS", 0, 0, 0, 0, 0, 1, 1
"e:\taroDemos\cloudmate\src\components\popover\index.tsx", "TypeScript JSX", 82, 0, 0, 0, 0, 14, 96
"e:\taroDemos\cloudmate\src\components\popover\use-floating.ts", "TypeScript", 0, 0, 122, 0, 0, 13, 135
"e:\taroDemos\cloudmate\src\components\radio\index.module.scss", "SCSS", 0, 17, 0, 0, 0, 5, 22
"e:\taroDemos\cloudmate\src\components\radio\index.tsx", "TypeScript JSX", 25, 0, 0, 0, 0, 5, 30
"e:\taroDemos\cloudmate\src\components\search\index.module.scss", "SCSS", 0, 12, 0, 0, 0, 1, 13
"e:\taroDemos\cloudmate\src\components\search\index.tsx", "TypeScript JSX", 18, 0, 0, 0, 0, 4, 22
"e:\taroDemos\cloudmate\src\components\tab-bar\constants.ts", "TypeScript", 0, 0, 53, 0, 0, 4, 57
"e:\taroDemos\cloudmate\src\components\tab-bar\index.config.ts", "TypeScript", 0, 0, 3, 0, 0, 1, 4
"e:\taroDemos\cloudmate\src\components\tab-bar\index.module.scss", "SCSS", 0, 77, 0, 0, 3, 11, 91
"e:\taroDemos\cloudmate\src\components\tab-bar\index.tsx", "TypeScript JSX", 48, 0, 0, 0, 2, 11, 61
"e:\taroDemos\cloudmate\src\components\textarea\index.module.scss", "SCSS", 0, 7, 0, 0, 0, 1, 8
"e:\taroDemos\cloudmate\src\components\textarea\index.tsx", "TypeScript JSX", 35, 0, 0, 0, 0, 8, 43
"e:\taroDemos\cloudmate\src\components\time-line\index.module.scss", "SCSS", 0, 33, 0, 0, 0, 5, 38
"e:\taroDemos\cloudmate\src\components\time-line\index.tsx", "TypeScript JSX", 72, 0, 0, 0, 0, 17, 89
"e:\taroDemos\cloudmate\src\constants\http.ts", "TypeScript", 0, 0, 4, 0, 2, 1, 7
"e:\taroDemos\cloudmate\src\hooks\useDebounce.ts", "TypeScript", 0, 0, 36, 0, 0, 6, 42
"e:\taroDemos\cloudmate\src\hooks\useDebounceCallback.ts", "TypeScript", 0, 0, 155, 0, 1, 27, 183
"e:\taroDemos\cloudmate\src\hooks\useLoadRequest.ts", "TypeScript", 0, 0, 43, 0, 0, 7, 50
"e:\taroDemos\cloudmate\src\hooks\useSwipeNavigation.ts", "TypeScript", 0, 0, 50, 0, 0, 7, 57
"e:\taroDemos\cloudmate\src\hooks\useSwitchTab.ts", "TypeScript", 0, 0, 19, 0, 0, 5, 24
"e:\taroDemos\cloudmate\src\hooks\useSystemInit.ts", "TypeScript", 0, 0, 46, 0, 0, 11, 57
"e:\taroDemos\cloudmate\src\hooks\useTime.ts", "TypeScript", 0, 0, 39, 0, 1, 8, 48
"e:\taroDemos\cloudmate\src\index.html", "HTML", 0, 0, 0, 17, 0, 1, 18
"e:\taroDemos\cloudmate\src\layout\common\index.module.scss", "SCSS", 0, 27, 0, 0, 0, 5, 32
"e:\taroDemos\cloudmate\src\layout\common\index.tsx", "TypeScript JSX", 40, 0, 0, 0, 0, 5, 45
"e:\taroDemos\cloudmate\src\pages\approval\components\dynamc-form\component-map.tsx", "TypeScript JSX", 15, 0, 0, 0, 1, 3, 19
"e:\taroDemos\cloudmate\src\pages\approval\components\dynamc-form\index.d.ts", "TypeScript", 0, 0, 43, 0, 0, 9, 52
"e:\taroDemos\cloudmate\src\pages\approval\components\dynamc-form\index.module.scss", "SCSS", 0, 48, 0, 0, 0, 8, 56
"e:\taroDemos\cloudmate\src\pages\approval\components\dynamc-form\index.tsx", "TypeScript JSX", 73, 0, 0, 0, 0, 9, 82
"e:\taroDemos\cloudmate\src\pages\approval\components\flow\components\edit-page.tsx", "TypeScript JSX", 59, 0, 0, 0, 0, 6, 65
"e:\taroDemos\cloudmate\src\pages\approval\components\flow\components\index.d.ts", "TypeScript", 0, 0, 18, 0, 0, 5, 23
"e:\taroDemos\cloudmate\src\pages\approval\components\flow\components\index.module.scss", "SCSS", 0, 156, 0, 0, 0, 21, 177
"e:\taroDemos\cloudmate\src\pages\approval\components\flow\components\index.tsx", "TypeScript JSX", 102, 0, 0, 0, 1, 11, 114
"e:\taroDemos\cloudmate\src\pages\approval\components\flow\components\removable-avatar.tsx", "TypeScript JSX", 29, 0, 0, 0, 0, 5, 34
"e:\taroDemos\cloudmate\src\pages\approval\components\flow\components\selected-page.tsx", "TypeScript JSX", 86, 0, 0, 0, 0, 11, 97
"e:\taroDemos\cloudmate\src\pages\approval\components\flow\index.module.scss", "SCSS", 0, 20, 0, 0, 0, 4, 24
"e:\taroDemos\cloudmate\src\pages\approval\components\flow\index.tsx", "TypeScript JSX", 78, 0, 0, 0, 0, 9, 87
"e:\taroDemos\cloudmate\src\pages\approval\components\picker\common\index.module.scss", "SCSS", 0, 51, 0, 0, 0, 10, 61
"e:\taroDemos\cloudmate\src\pages\approval\components\picker\common\index.tsx", "TypeScript JSX", 63, 0, 0, 0, 0, 13, 76
"e:\taroDemos\cloudmate\src\pages\approval\components\picker\date\context.tsx", "TypeScript JSX", 17, 0, 0, 0, 0, 4, 21
"e:\taroDemos\cloudmate\src\pages\approval\components\picker\date\date-picker.tsx", "TypeScript JSX", 74, 0, 0, 0, 0, 10, 84
"e:\taroDemos\cloudmate\src\pages\approval\components\picker\date\index.d.ts", "TypeScript", 0, 0, 8, 0, 0, 1, 9
"e:\taroDemos\cloudmate\src\pages\approval\components\picker\date\index.module.scss", "SCSS", 0, 163, 0, 0, 5, 21, 189
"e:\taroDemos\cloudmate\src\pages\approval\components\picker\date\index.tsx", "TypeScript JSX", 4, 0, 0, 0, 0, 2, 6
"e:\taroDemos\cloudmate\src\pages\approval\components\picker\date\picker-selector.tsx", "TypeScript JSX", 47, 0, 0, 0, 1, 11, 59
"e:\taroDemos\cloudmate\src\pages\approval\components\picker\date\segmented-control.tsx", "TypeScript JSX", 29, 0, 0, 0, 0, 4, 33
"e:\taroDemos\cloudmate\src\pages\approval\components\picker\date\select-date.tsx", "TypeScript JSX", 146, 0, 0, 0, 0, 27, 173
"e:\taroDemos\cloudmate\src\pages\approval\components\picker\date\select-time.tsx", "TypeScript JSX", 62, 0, 0, 0, 0, 10, 72
"e:\taroDemos\cloudmate\src\pages\approval\components\picker\date\utils.ts", "TypeScript", 0, 0, 44, 0, 0, 15, 59
"e:\taroDemos\cloudmate\src\pages\approval\components\picker\image\index.module.scss", "SCSS", 0, 15, 0, 0, 0, 3, 18
"e:\taroDemos\cloudmate\src\pages\approval\components\picker\image\index.tsx", "TypeScript JSX", 22, 0, 0, 0, 0, 5, 27
"e:\taroDemos\cloudmate\src\pages\approval\components\status-icon\index.module.scss", "SCSS", 0, 14, 0, 0, 0, 1, 15
"e:\taroDemos\cloudmate\src\pages\approval\components\status-icon\index.tsx", "TypeScript JSX", 24, 0, 0, 0, 0, 5, 29
"e:\taroDemos\cloudmate\src\pages\approval\components\text\input\index.module.scss", "SCSS", 0, 25, 0, 0, 0, 5, 30
"e:\taroDemos\cloudmate\src\pages\approval\components\text\input\index.tsx", "TypeScript JSX", 43, 0, 0, 0, 0, 7, 50
"e:\taroDemos\cloudmate\src\pages\approval\components\text\textarea\index.module.scss", "SCSS", 0, 33, 0, 0, 0, 6, 39
"e:\taroDemos\cloudmate\src\pages\approval\components\text\textarea\index.tsx", "TypeScript JSX", 43, 0, 0, 0, 0, 7, 50
"e:\taroDemos\cloudmate\src\pages\approval\config\constants.ts", "TypeScript", 0, 0, 72, 0, 0, 15, 87
"e:\taroDemos\cloudmate\src\pages\approval\config\create.ts", "TypeScript", 0, 0, 518, 0, 0, 6, 524
"e:\taroDemos\cloudmate\src\pages\approval\config\detail.ts", "TypeScript", 0, 0, 161, 0, 0, 18, 179
"e:\taroDemos\cloudmate\src\pages\approval\config\home.ts", "TypeScript", 0, 0, 49, 0, 0, 4, 53
"e:\taroDemos\cloudmate\src\pages\approval\config\process.ts", "TypeScript", 0, 0, 23, 0, 0, 2, 25
"e:\taroDemos\cloudmate\src\pages\approval\context.tsx", "TypeScript JSX", 15, 0, 0, 0, 0, 4, 19
"e:\taroDemos\cloudmate\src\pages\approval\index.tsx", "TypeScript JSX", 23, 0, 0, 0, 9, 2, 34
"e:\taroDemos\cloudmate\src\pages\approval\types\index.d.ts", "TypeScript", 0, 0, 11, 0, 0, 4, 15
"e:\taroDemos\cloudmate\src\pages\approval\utils\utils.ts", "TypeScript", 0, 0, 72, 0, 0, 12, 84
"e:\taroDemos\cloudmate\src\pages\approval\utils\validate.ts", "TypeScript", 0, 0, 62, 0, 0, 16, 78
"e:\taroDemos\cloudmate\src\pages\approval\views\create\index.tsx", "TypeScript JSX", 109, 0, 0, 0, 0, 10, 119
"e:\taroDemos\cloudmate\src\pages\approval\views\detail\components\flow\index.module.scss", "SCSS", 0, 38, 0, 0, 0, 4, 42
"e:\taroDemos\cloudmate\src\pages\approval\views\detail\components\flow\index.tsx", "TypeScript JSX", 58, 0, 0, 0, 0, 5, 63
"e:\taroDemos\cloudmate\src\pages\approval\views\detail\hooks\useApprovalActions.ts", "TypeScript", 0, 0, 87, 0, 0, 11, 98
"e:\taroDemos\cloudmate\src\pages\approval\views\detail\hooks\useApprovalDetail.ts", "TypeScript", 0, 0, 46, 0, 0, 8, 54
"e:\taroDemos\cloudmate\src\pages\approval\views\detail\index.d.ts", "TypeScript", 0, 0, 68, 0, 7, 12, 87
"e:\taroDemos\cloudmate\src\pages\approval\views\detail\index.module.scss", "SCSS", 0, 77, 0, 0, 1, 10, 88
"e:\taroDemos\cloudmate\src\pages\approval\views\detail\index.tsx", "TypeScript JSX", 119, 0, 0, 0, 0, 13, 132
"e:\taroDemos\cloudmate\src\pages\approval\views\home\index.module.scss", "SCSS", 0, 51, 0, 0, 0, 7, 58
"e:\taroDemos\cloudmate\src\pages\approval\views\home\index.tsx", "TypeScript JSX", 67, 0, 0, 0, 1, 13, 81
"e:\taroDemos\cloudmate\src\pages\approval\views\process\components\approval-item\index.module.scss", "SCSS", 0, 29, 0, 0, 0, 3, 32
"e:\taroDemos\cloudmate\src\pages\approval\views\process\components\approval-item\index.tsx", "TypeScript JSX", 36, 0, 0, 0, 0, 7, 43
"e:\taroDemos\cloudmate\src\pages\approval\views\process\components\process-tag\index.module.scss", "SCSS", 0, 7, 0, 0, 0, 1, 8
"e:\taroDemos\cloudmate\src\pages\approval\views\process\components\process-tag\index.tsx", "TypeScript JSX", 27, 0, 0, 0, 0, 5, 32
"e:\taroDemos\cloudmate\src\pages\approval\views\process\index.module.scss", "SCSS", 0, 43, 0, 0, 0, 6, 49
"e:\taroDemos\cloudmate\src\pages\approval\views\process\index.tsx", "TypeScript JSX", 81, 0, 0, 0, 1, 12, 94
"e:\taroDemos\cloudmate\src\pages\chat\components\chat-composer\index.module.scss", "SCSS", 0, 41, 0, 0, 4, 3, 48
"e:\taroDemos\cloudmate\src\pages\chat\components\chat-composer\index.tsx", "TypeScript JSX", 110, 0, 0, 0, 0, 13, 123
"e:\taroDemos\cloudmate\src\pages\chat\components\message-item\components\approval\done\index.module.scss", "SCSS", 0, 35, 0, 0, 0, 4, 39
"e:\taroDemos\cloudmate\src\pages\chat\components\message-item\components\approval\done\index.tsx", "TypeScript JSX", 64, 0, 0, 0, 1, 10, 75
"e:\taroDemos\cloudmate\src\pages\chat\components\message-item\components\approval\init\index.module.scss", "SCSS", 0, 35, 0, 0, 0, 4, 39
"e:\taroDemos\cloudmate\src\pages\chat\components\message-item\components\approval\init\index.tsx", "TypeScript JSX", 64, 0, 0, 0, 1, 9, 74
"e:\taroDemos\cloudmate\src\pages\chat\components\message-item\components\approval\next\index.module.scss", "SCSS", 0, 59, 0, 0, 0, 5, 64
"e:\taroDemos\cloudmate\src\pages\chat\components\message-item\components\approval\next\index.tsx", "TypeScript JSX", 90, 0, 0, 0, 1, 11, 102
"e:\taroDemos\cloudmate\src\pages\chat\components\message-item\context.tsx", "TypeScript JSX", 7, 0, 0, 0, 0, 3, 10
"e:\taroDemos\cloudmate\src\pages\chat\components\message-item\index.module.scss", "SCSS", 0, 50, 0, 0, 0, 5, 55
"e:\taroDemos\cloudmate\src\pages\chat\components\message-item\index.tsx", "TypeScript JSX", 95, 0, 0, 0, 0, 12, 107
"e:\taroDemos\cloudmate\src\pages\chat\context.tsx", "TypeScript JSX", 11, 0, 0, 0, 0, 3, 14
"e:\taroDemos\cloudmate\src\pages\chat\hooks\useAutoScrollToButtom.ts", "TypeScript", 0, 0, 20, 0, 1, 8, 29
"e:\taroDemos\cloudmate\src\pages\chat\index.tsx", "TypeScript JSX", 37, 0, 0, 0, 0, 6, 43
"e:\taroDemos\cloudmate\src\pages\chat\utils.ts", "TypeScript", 0, 0, 14, 0, 0, 3, 17
"e:\taroDemos\cloudmate\src\pages\chat\views\main-content\index.module.scss", "SCSS", 0, 61, 0, 0, 0, 10, 71
"e:\taroDemos\cloudmate\src\pages\chat\views\main-content\index.tsx", "TypeScript JSX", 122, 0, 0, 0, 2, 18, 142
"e:\taroDemos\cloudmate\src\pages\chat\views\setting\components\chat-record\date\index.module.scss", "SCSS", 0, 53, 0, 0, 0, 5, 58
"e:\taroDemos\cloudmate\src\pages\chat\views\setting\components\chat-record\date\index.tsx", "TypeScript JSX", 144, 0, 0, 0, 2, 16, 162
"e:\taroDemos\cloudmate\src\pages\chat\views\setting\components\chat-record\keywords\index.module.scss", "SCSS", 0, 50, 0, 0, 0, 7, 57
"e:\taroDemos\cloudmate\src\pages\chat\views\setting\components\chat-record\keywords\index.tsx", "TypeScript JSX", 87, 0, 0, 0, 1, 14, 102
"e:\taroDemos\cloudmate\src\pages\chat\views\setting\context.tsx", "TypeScript JSX", 10, 0, 0, 0, 0, 3, 13
"e:\taroDemos\cloudmate\src\pages\chat\views\setting\index.module.scss", "SCSS", 0, 24, 0, 0, 1, 3, 28
"e:\taroDemos\cloudmate\src\pages\chat\views\setting\index.tsx", "TypeScript JSX", 95, 0, 0, 0, 0, 14, 109
"e:\taroDemos\cloudmate\src\pages\company\index.tsx", "TypeScript JSX", 16, 0, 0, 0, 0, 4, 20
"e:\taroDemos\cloudmate\src\pages\company\views\attendance\components\atd-button\index.module.scss", "SCSS", 0, 12, 0, 0, 0, 1, 13
"e:\taroDemos\cloudmate\src\pages\company\views\attendance\components\atd-button\index.tsx", "TypeScript JSX", 45, 0, 0, 0, 2, 8, 55
"e:\taroDemos\cloudmate\src\pages\company\views\attendance\components\atd-record\index.module.scss", "SCSS", 0, 39, 0, 0, 0, 4, 43
"e:\taroDemos\cloudmate\src\pages\company\views\attendance\components\atd-record\index.tsx", "TypeScript JSX", 110, 0, 0, 0, 0, 22, 132
"e:\taroDemos\cloudmate\src\pages\company\views\attendance\context.ts", "TypeScript", 0, 0, 9, 0, 0, 3, 12
"e:\taroDemos\cloudmate\src\pages\company\views\attendance\index.module.scss", "SCSS", 0, 3, 0, 0, 0, 1, 4
"e:\taroDemos\cloudmate\src\pages\company\views\attendance\index.tsx", "TypeScript JSX", 17, 0, 0, 0, 0, 3, 20
"e:\taroDemos\cloudmate\src\pages\company\views\time\index.module.scss", "SCSS", 0, 38, 0, 0, 2, 4, 44
"e:\taroDemos\cloudmate\src\pages\company\views\time\index.tsx", "TypeScript JSX", 20, 0, 0, 0, 0, 3, 23
"e:\taroDemos\cloudmate\src\pages\file\components\action-sheet\edit-file\index.module.scss", "SCSS", 0, 26, 0, 0, 0, 5, 31
"e:\taroDemos\cloudmate\src\pages\file\components\action-sheet\edit-file\index.tsx", "TypeScript JSX", 118, 0, 0, 0, 6, 18, 142
"e:\taroDemos\cloudmate\src\pages\file\components\action-sheet\new-folder\index.module.scss", "SCSS", 0, 34, 0, 0, 0, 4, 38
"e:\taroDemos\cloudmate\src\pages\file\components\action-sheet\new-folder\index.tsx", "TypeScript JSX", 65, 0, 0, 0, 0, 11, 76
"e:\taroDemos\cloudmate\src\pages\file\components\breadcrumbs\index.module.scss", "SCSS", 0, 20, 0, 0, 1, 3, 24
"e:\taroDemos\cloudmate\src\pages\file\components\breadcrumbs\index.tsx", "TypeScript JSX", 52, 0, 0, 0, 0, 10, 62
"e:\taroDemos\cloudmate\src\pages\file\components\file-list\components\file-item\index.module.scss", "SCSS", 0, 82, 0, 0, 0, 9, 91
"e:\taroDemos\cloudmate\src\pages\file\components\file-list\components\file-item\index.tsx", "TypeScript JSX", 52, 0, 0, 0, 0, 10, 62
"e:\taroDemos\cloudmate\src\pages\file\components\file-list\index.module.scss", "SCSS", 0, 24, 0, 0, 0, 3, 27
"e:\taroDemos\cloudmate\src\pages\file\components\file-list\index.tsx", "TypeScript JSX", 29, 0, 0, 0, 0, 9, 38
"e:\taroDemos\cloudmate\src\pages\file\components\modal\file-rename\index.module.scss", "SCSS", 0, 30, 0, 0, 0, 5, 35
"e:\taroDemos\cloudmate\src\pages\file\components\modal\file-rename\index.tsx", "TypeScript JSX", 50, 0, 0, 0, 0, 10, 60
"e:\taroDemos\cloudmate\src\pages\file\components\tools\index.module.scss", "SCSS", 0, 33, 0, 0, 0, 4, 37
"e:\taroDemos\cloudmate\src\pages\file\components\tools\index.tsx", "TypeScript JSX", 95, 0, 0, 0, 5, 16, 116
"e:\taroDemos\cloudmate\src\pages\file\context.ts", "TypeScript", 0, 0, 14, 0, 0, 8, 22
"e:\taroDemos\cloudmate\src\pages\file\hooks\use-fetch-flie-fist.ts", "TypeScript", 0, 0, 28, 0, 0, 5, 33
"e:\taroDemos\cloudmate\src\pages\file\hooks\use-file-handler.ts", "TypeScript", 0, 0, 70, 0, 0, 9, 79
"e:\taroDemos\cloudmate\src\pages\file\hooks\use-popup-manager.tsx", "TypeScript JSX", 44, 0, 0, 0, 0, 7, 51
"e:\taroDemos\cloudmate\src\pages\file\index.module.scss", "SCSS", 0, 17, 0, 0, 0, 2, 19
"e:\taroDemos\cloudmate\src\pages\file\index.tsx", "TypeScript JSX", 27, 0, 0, 0, 0, 4, 31
"e:\taroDemos\cloudmate\src\pages\file\utils\index.ts", "TypeScript", 0, 0, 4, 0, 0, 1, 5
"e:\taroDemos\cloudmate\src\pages\file\views\main-content\index.tsx", "TypeScript JSX", 52, 0, 0, 0, 0, 9, 61
"e:\taroDemos\cloudmate\src\pages\file\views\search-file\index.module.scss", "SCSS", 0, 43, 0, 0, 0, 4, 47
"e:\taroDemos\cloudmate\src\pages\file\views\search-file\index.tsx", "TypeScript JSX", 67, 0, 0, 0, 10, 12, 89
"e:\taroDemos\cloudmate\src\pages\group\components\contacts\index.module.scss", "SCSS", 0, 66, 0, 0, 0, 6, 72
"e:\taroDemos\cloudmate\src\pages\group\components\contacts\index.tsx", "TypeScript JSX", 66, 0, 0, 0, 0, 15, 81
"e:\taroDemos\cloudmate\src\pages\group\components\header\index.tsx", "TypeScript JSX", 30, 0, 0, 0, 0, 6, 36
"e:\taroDemos\cloudmate\src\pages\group\components\tools\index.module.scss", "SCSS", 0, 23, 0, 0, 0, 3, 26
"e:\taroDemos\cloudmate\src\pages\group\components\tools\index.tsx", "TypeScript JSX", 16, 0, 0, 0, 0, 4, 20
"e:\taroDemos\cloudmate\src\pages\group\components\tools\search-bar\index.module.scss", "SCSS", 0, 18, 0, 0, 0, 3, 21
"e:\taroDemos\cloudmate\src\pages\group\components\tools\search-bar\index.tsx", "TypeScript JSX", 11, 0, 0, 0, 0, 3, 14
"e:\taroDemos\cloudmate\src\pages\group\context.tsx", "TypeScript JSX", 10, 0, 0, 0, 0, 4, 14
"e:\taroDemos\cloudmate\src\pages\group\index.module.scss", "SCSS", 0, 14, 0, 0, 0, 2, 16
"e:\taroDemos\cloudmate\src\pages\group\index.tsx", "TypeScript JSX", 33, 0, 0, 0, 0, 5, 38
"e:\taroDemos\cloudmate\src\pages\index\anim.scss", "SCSS", 0, 25, 0, 0, 0, 5, 30
"e:\taroDemos\cloudmate\src\pages\index\index.module.scss", "SCSS", 0, 7, 0, 0, 0, 1, 8
"e:\taroDemos\cloudmate\src\pages\index\index.tsx", "TypeScript JSX", 28, 0, 0, 0, 28, 4, 60
"e:\taroDemos\cloudmate\src\pages\login\index.module.scss", "SCSS", 0, 60, 0, 0, 0, 9, 69
"e:\taroDemos\cloudmate\src\pages\login\index.tsx", "TypeScript JSX", 83, 0, 0, 0, 0, 7, 90
"e:\taroDemos\cloudmate\src\pages\not-found\index.tsx", "TypeScript JSX", 7, 0, 0, 0, 0, 3, 10
"e:\taroDemos\cloudmate\src\pages\profile\components\featrue\index.module.scss", "SCSS", 0, 25, 0, 0, 0, 4, 29
"e:\taroDemos\cloudmate\src\pages\profile\components\featrue\index.tsx", "TypeScript JSX", 23, 0, 0, 0, 0, 7, 30
"e:\taroDemos\cloudmate\src\pages\profile\components\user-detail\index.module.scss", "SCSS", 0, 29, 0, 0, 0, 3, 32
"e:\taroDemos\cloudmate\src\pages\profile\components\user-detail\index.tsx", "TypeScript JSX", 27, 0, 0, 0, 0, 5, 32
"e:\taroDemos\cloudmate\src\pages\profile\index.module.scss", "SCSS", 0, 27, 0, 0, 0, 5, 32
"e:\taroDemos\cloudmate\src\pages\profile\index.tsx", "TypeScript JSX", 54, 0, 0, 0, 0, 6, 60
"e:\taroDemos\cloudmate\src\socket\index.ts", "TypeScript", 0, 0, 112, 0, 1, 27, 140
"e:\taroDemos\cloudmate\src\store\index.ts", "TypeScript", 0, 0, 22, 0, 0, 4, 26
"e:\taroDemos\cloudmate\src\store\reducers\attandence.ts", "TypeScript", 0, 0, 22, 0, 0, 6, 28
"e:\taroDemos\cloudmate\src\store\reducers\auth.ts", "TypeScript", 0, 0, 31, 0, 0, 9, 40
"e:\taroDemos\cloudmate\src\store\reducers\chat.ts", "TypeScript", 0, 0, 0, 0, 66, 9, 75
"e:\taroDemos\cloudmate\src\store\reducers\contacts.ts", "TypeScript", 0, 0, 71, 0, 0, 6, 77
"e:\taroDemos\cloudmate\src\store\reducers\file.ts", "TypeScript", 0, 0, 55, 0, 0, 6, 61
"e:\taroDemos\cloudmate\src\store\reducers\index.tsx", "TypeScript JSX", 6, 0, 0, 0, 0, 1, 7
"e:\taroDemos\cloudmate\src\store\reducers\tabbar.ts", "TypeScript", 0, 0, 17, 0, 0, 5, 22
"e:\taroDemos\cloudmate\src\store\reducers\user.ts", "TypeScript", 0, 0, 26, 0, 0, 5, 31
"e:\taroDemos\cloudmate\src\store\selectors\attandence.ts", "TypeScript", 0, 0, 4, 0, 0, 4, 8
"e:\taroDemos\cloudmate\src\store\selectors\auth.ts", "TypeScript", 0, 0, 4, 0, 0, 4, 8
"e:\taroDemos\cloudmate\src\store\selectors\chat.ts", "TypeScript", 0, 0, 0, 0, 3, 3, 6
"e:\taroDemos\cloudmate\src\store\selectors\contacts.ts", "TypeScript", 0, 0, 14, 0, 0, 6, 20
"e:\taroDemos\cloudmate\src\store\selectors\file.ts", "TypeScript", 0, 0, 3, 0, 0, 3, 6
"e:\taroDemos\cloudmate\src\store\selectors\tabbar.ts", "TypeScript", 0, 0, 2, 0, 0, 2, 4
"e:\taroDemos\cloudmate\src\store\selectors\user.ts", "TypeScript", 0, 0, 2, 0, 0, 2, 4
"e:\taroDemos\cloudmate\src\style\index.scss", "SCSS", 0, 5, 0, 0, 0, 1, 6
"e:\taroDemos\cloudmate\src\types\attandence.d.ts", "TypeScript", 0, 0, 7, 0, 0, 4, 11
"e:\taroDemos\cloudmate\src\types\auth.d.ts", "TypeScript", 0, 0, 5, 0, 0, 1, 6
"e:\taroDemos\cloudmate\src\types\contacts.d.ts", "TypeScript", 0, 0, 0, 0, 0, 1, 1
"e:\taroDemos\cloudmate\src\types\file.d.ts", "TypeScript", 0, 0, 31, 0, 0, 11, 42
"e:\taroDemos\cloudmate\src\types\icon.d.ts", "TypeScript", 0, 0, 58, 0, 0, 5, 63
"e:\taroDemos\cloudmate\src\types\message.d.ts", "TypeScript", 0, 0, 45, 0, 0, 12, 57
"e:\taroDemos\cloudmate\src\types\profile.d.ts", "TypeScript", 0, 0, 13, 0, 0, 2, 15
"e:\taroDemos\cloudmate\src\utils\common.ts", "TypeScript", 0, 0, 26, 0, 0, 5, 31
"e:\taroDemos\cloudmate\src\utils\date.ts", "TypeScript", 0, 0, 52, 0, 7, 14, 73
"e:\taroDemos\cloudmate\src\utils\error.ts", "TypeScript", 0, 0, 6, 0, 0, 1, 7
"e:\taroDemos\cloudmate\src\utils\navigate.ts", "TypeScript", 0, 0, 12, 0, 0, 4, 16
"e:\taroDemos\cloudmate\src\utils\object.ts", "TypeScript", 0, 0, 3, 0, 0, 2, 5
"Total", "-", 4678, 2526, 3064, 17, 189, 1619, 12093